6 13 2
|-----------|
|F..-...-...|
|.-...|...-.|
|...-.|.-@..|
|.-F......-.|
|-----------|