6 13 2
|-----------|
|F..-...-PF.|
|.-...|...-.|
|...-.|.-...|
|P-...|...-@|
|-----------|